2
14 10
x xxxxxxxxxxxx
xp mm  mO p mx
x  mm  m   xxx
x  mm  mm mxxx
x  mm  mm yxxx
x  mm  mm  xxx
x  mm  mm  xxx
x  mm  mm  xxx
x  mm  mm  xxx
x xxxxxxxxxxxx
