2
14 10
xxxxmxxxxxxxxx
mm          mm
x  mmppmm  xxx
x  mm  mm  xxx
x  m   mm  xxx
x  m   m   xxx
x  m   mm  xxx
x  mm  mm  xxx
x  mm  mm  xxx
xxxxmxxmxxxxxx