2
14 10
xxxxxxxxxxxxxx
xp mm  mO p mx
x  mm  m   xxx
x  mm  mm mxxx
x  mm  mm yxxx
x  mm  mm  xxx
x  mm  mm  xxx
x  mm  mm  xxx
x  mm  mm  xxx
xxxxxxxxxxxxxx
