2
14 10
x xxxxxxxxxxxx
xp@ $ p mm pxx
x  mm  mmm  xx
x  mm  mmm  xx
x  mm  mmm xxx
x  mm  mmm  xx
x  mm  mmm xxx
x  mm  mmm  xx
xp mm p mm pxx
x xxxxxxxxxxxx
