2
14 10
xxxxxxxxxxxxxx
xp mp  mm  xxx
x  mm  mm  xxx
x ymm  mm  xxx
x   m  mm  xxx
x  mm  mm  xxx
x  mm  mm  xxx
x  mm  mm  xxx
x  mm  mm  xxx
xxxxxxxxxxxxxx
