2
14 10
x xxxxxxxxxxxx
x pmm mmm  pxx
x  mm  mm  xxx
x  mm  mm mxxx
x  mm  mm  xxx
x  mm  mm  xxx
x  mm  mm  xxx
x  mm  mm  xxx
xp mm  mm  pxx
x xxxxxxxxxxxx
